%s used of %s %s %%=Użyte %s z %s (%s %%)
---=---
Active tunnels=Aktivni predori
Activity=Dejavnost
ago=od
Airflow=Pretok zraka
All Apps=Vse docker aplikacije
All VMs=Vsi VM-ji
Battery charge=Polnjenje baterije
BIOS dated=BIOS z datumom
Click to toggle details=Kliknite za prikaz podrobnosti
Completed=Dokončano
Counters info=Informacije o števcih
Current operation %s on %s=Trenutna operacija %s na **%s**
custom image=slika po meri 
Data is invalid=Podatki so neveljavni 
default image=privzeta slika
Docker Containers=Docker zabojniki
Due in=Konec v
Elapsed time=Pretečeni čas
Errors info=Informacije o napakah
Estimated finish=Predvideni zaključek
failed device=napačna naprava
Fan count=Število ventilatorjev
FAN=VENTILATOR
Finding %s error=Iskanje napake: **%s** błąd
Finding %s errors=Iskanje napak: **%s** błędów
General info=Splošne informacije
Go to cache settings=Pojdite na nastavitve predpomnilnika
Go to CPU pinning settings=Pojdite na nastavitve pripenjanja CPU
Go to disk settings=Pojdite na nastavitve diska
Go to Docker settings=Pojdite na nastavitve Docker
Go to fan settings=Pojdite na nastavitve ventilatorja
Go to identification settings=Pojdite na nastavitve identifikacije
Go to network settings=Pojdite na omrežne nastavitve
Go to scheduler settings=Pojdite na nastavitve razporejevalnika
Go to Share settings=Pojdite na Share nastavitve
Go to UPS settings=Pojdite na nastavitve UPS
Go to User settings=Pojdite na Uporabniške nastavitve
Go to VM settings=Pojdite na nastavitve VM
Go to VPN settings=Pojdite na nastavitve VPN 
Handshake=Rokovanje
has=ima
healthy=zdrowy
heat warning=ostrzeżenie temperaturowe
Hide details=Ukryj szczegóły
in progress=w trakcie
Inactive tunnels=Nieaktywny tunel
inactive=nieaktywny
Inbound=Przychodzący
invalid device=nieprawidłowe urządzenie
invalid devices=nieprawidłowe urządzenia
Last check completed on %s=Ostatnie sprawdzenie ukończono **%s**
Last check incomplete on %s=Ostatnie przerwanie sprawdzenia **%s**
Last checked on %s=Ostatnie sprawdzenie **%s**
Maximum size=Maksymalny rozmiar
Mode of operation=Tryb pracy
Next check scheduled on %s=Następne sprawdzenie zaplanowano na **%s**
No docker containers defined=Brak zdefiniowanych kontenerów Dockera
No running docker containers=Brak uruchomionych kontenerów Dockera
No running virtual machines=Brak uruchomionych maszyn wirtualnych
No shares present=Brak udziałów
No virtual machines defined=Brak zdefiniowanych maszyn wirtualnych
Nominal power=Moc nominalna
not received=nieodebrany
Outbound=Wychodzący
Overall Load=Obciążenie całkowite
Parity disk not present=Dysk parzystości nie istnieje
Parity disks not present=Dyski parzystości nie istnieją
Parity has not been checked yet=Parzystość nie została jeszcze sprawdzona
Parity is degraded=Parzystość jest zdegradowana
Power=Moc
Put system to sleep=Uśpij system
Reboot the system=Uruchom system ponownie
Receive counters=Odebrane liczniki
Received packets=Odebrane pakiety
Runtime left=Pozostały czas pracy
Scheduled parity check is disabled=Zaplanowane sprawdzenie parzystości jest wyłączone
Select Case Model=Wybierz model obudowy
Share count %s with %s cache only and %s encrypted=Liczba udziałów: %s, w tym %s tylko w pamięci podręcznej i %s zaszyfrowanych
Show details=Pokaż szczegóły
Show Information=Pokaż informacje
Shutdown the system=Zamknij system
SMART error=Błąd SMART
SMART=SMART
sn=numer seryjny
Start the array=Uruchom macierz
Started only=Tylko uruchomione
Stop the array=Zatrzymaj macierz
This will put the system to sleep=To uśpi system
This will reboot the system=To uruchomi system ponownie
This will shutdown the system=To zamknie system
This will start the array=To uruchomi macierz
This will stop the array=To zatrzyma macierz
Transmit counters=Wysłane liczniki
Transmitted packets=Wysłane pakiety
UPS Load=Obciążenie UPS
UPS status=Status UPS
Usable size=Użyteczny rozmiar
User count %s with %s unprotected=Liczba użytkowników: %s, w tym %s niezabezpieczonych
utilization warning=ostrzeżenie o poziomie użycia
View Running Processes=Pokaż uruchomione procesy
Virtual Machines=Maszyny wirtualne

; New entries - 2021-03-14
Temp=
